5 5 5 3 3 3 5 3 3 3 3 5 5 5 5 5 5 5 5 5 5 5 5 5 5 5 5 5 5 5 5 5 5 5 5 5 5 5 5 5 5 5 5 5 5 5 5 5 5 5
3 0 0 0 0 0 0 0 0 0 0 9 5 5 5 5 5 5 3 3 3 1 1 3 3 1 1 3 3 4 4 4 4 4 4 4 4 4 4 4 4 4 4 4 4 4 4 4 6 5
3 0 0 0 0 0 0 0 0 0 0 2 2 2 2 2 2 2 4 4 3 1 1 3 3 1 1 3 3 4 4 4 3 3 3 4 4 4 4 3 3 3 3 3 3 3 3 3 3 5
3 0 0 0 0 0 0 0 0 0 0 2 2 2 2 2 2 2 4 4 3 1 1 3 3 1 1 3 3 4 4 4 3 3 3 4 4 4 4 3 3 3 3 3 3 3 3 3 3 5
3 0 0 0 0 0 0 0 0 0 0 5 5 5 5 5 3 4 4 4 3 1 1 3 3 1 1 3 3 4 4 4 4 4 4 4 4 4 4 1 1 1 1 1 1 1 1 1 1 5
3 0 0 0 0 0 0 0 0 0 0 0 0 0 0 5 3 4 4 4 3 1 1 3 3 1 1 3 3 4 4 4 3 3 3 4 4 4 4 1 1 1 1 1 1 1 1 1 1 5
3 0 6 6 6 0 0 0 0 0 0 0 0 0 0 5 3 4 4 4 3 1 1 3 3 1 1 3 3 4 4 4 3 3 3 4 4 4 4 3 3 3 3 3 3 3 3 3 3 5
3 0 0 6 6 6 6 0 0 0 0 0 0 0 0 5 3 4 4 4 3 1 1 3 3 1 1 3 3 4 4 4 5 6 6 4 4 4 4 3 3 3 3 3 7 3 3 3 3 5
5 0 0 6 6 6 0 0 0 0 0 0 0 0 0 5 3 4 4 4 4 4 4 4 4 4 4 4 4 4 4 4 5 6 4 4 4 4 4 4 4 4 4 4 4 4 4 4 4 5
5 0 0 0 0 0 0 0 0 0 0 0 0 0 0 5 3 4 4 4 4 4 4 4 4 4 4 4 4 4 4 4 5 4 4 4 4 4 4 4 4 4 4 4 4 4 4 4 4 5
5 0 0 0 0 0 0 0 6 6 6 6 0 0 0 5 5 4 4 4 4 4 4 4 4 4 4 4 4 4 4 4 5 4 4 4 4 4 4 4 4 4 4 4 4 4 4 4 4 5
5 5 5 5 5 5 5 5 5 5 5 5 5 5 5 5 5 5 5 5 5 5 5 5 5 5 5 5 5 5 5 5 5 4 4 4 4 4 4 4 4 4 4 4 4 4 4 4 4 5
5 4 4 3 3 1 1 3 3 1 1 3 3 3 5 3 3 1 1 3 3 1 1 3 5 3 3 3 3 3 3 3 5 4 4 4 4 4 4 4 4 4 4 4 4 4 4 4 4 5
5 3 4 3 3 1 1 3 3 1 1 3 1 3 5 3 1 1 1 3 3 1 1 3 5 4 4 4 4 4 4 4 5 4 4 4 4 5 2 2 5 4 4 4 4 4 4 4 4 5
5 4 4 3 3 1 1 3 3 1 1 3 1 3 5 3 1 1 1 3 3 1 1 3 5 4 4 4 6 4 4 4 5 4 4 4 4 5 2 2 9 4 4 4 4 4 4 4 4 5
5 4 4 3 3 1 1 3 3 1 1 1 1 3 5 3 1 1 1 3 3 1 1 3 5 4 6 4 8 4 6 6 5 5 5 5 5 5 2 2 5 5 5 5 5 5 5 5 5 5
5 4 3 3 3 1 1 3 3 1 1 3 3 3 5 3 3 1 1 3 3 1 1 3 5 4 6 6 6 4 4 1 5 3 3 3 3 5 2 2 10 3 3 3 3 3 3 3 3 5
5 4 4 3 3 1 1 3 3 1 1 1 5 5 5 5 5 1 1 3 3 1 1 3 5 4 4 4 4 4 4 4 5 3 4 4 4 5 2 2 5 4 4 4 4 4 4 4 4 5
5 4 4 4 4 4 4 4 4 4 4 4 2 2 2 2 2 4 4 4 4 4 4 4 4 4 4 4 4 4 4 4 5 3 4 4 4 5 2 2 5 4 4 4 4 4 4 4 4 5
5 3 3 3 3 4 4 4 4 4 4 4 2 2 2 2 2 4 4 4 4 4 4 4 4 4 4 4 4 4 4 4 4 4 4 4 4 4 4 4 4 4 6 6 4 4 4 4 4 5
5 3 3 3 3 4 4 4 4 4 4 4 5 11 5 10 5 4 4 4 4 4 4 4 4 4 4 4 4 4 4 4 4 4 4 4 4 4 4 4 4 4 6 4 6 6 6 4 4 5
5 4 4 4 4 4 4 4 4 4 4 4 4 3 5 3 3 3 4 4 4 4 4 4 4 4 4 4 4 4 4 4 4 4 4 4 4 4 4 4 4 4 4 4 6 6 4 4 4 5
5 4 4 4 4 4 4 4 4 4 4 4 4 3 5 0 0 0 0 0 0 0 0 0 6 6 6 0 5 4 4 4 4 4 4 4 4 4 4 4 4 4 4 4 6 6 4 4 4 5
5 3 3 3 3 4 4 4 4 3 3 3 3 3 5 0 0 6 6 0 0 0 0 0 0 0 0 0 5 4 4 4 4 4 5 2 2 5 4 4 4 4 4 4 4 4 4 4 4 5
5 3 3 3 3 4 4 4 4 3 3 3 3 3 5 0 0 6 6 0 0 0 0 6 6 0 0 0 5 4 4 4 4 4 5 2 2 10 4 4 4 4 4 4 4 4 4 4 4 5
5 4 4 4 4 4 4 4 4 4 4 4 4 3 5 0 0 0 0 0 0 6 6 6 6 6 0 0 5 5 5 5 5 5 5 2 2 5 5 5 5 5 5 5 5 5 5 5 5 5
5 4 4 4 4 4 4 4 4 4 4 4 6 3 5 0 0 0 0 0 0 6 0 0 6 6 0 0 5 3 3 4 4 4 5 2 2 13 4 4 4 4 4 3 3 3 3 3 3 5
5 3 3 3 3 4 4 4 4 4 4 4 6 3 5 6 6 6 6 6 0 0 0 0 0 0 0 0 5 4 4 4 4 4 5 2 2 5 4 4 4 4 4 4 4 4 4 4 4 5
5 3 3 3 3 4 4 4 4 4 4 4 4 3 5 5 5 5 5 5 5 5 5 5 5 5 5 5 5 4 4 4 4 4 4 4 4 4 4 4 4 4 4 4 4 4 4 4 4 5
5 4 4 4 4 4 4 4 4 3 3 4 4 3 3 3 3 3 5 3 4 4 3 3 4 4 3 3 5 4 4 4 6 6 6 4 4 4 4 4 4 4 4 3 3 3 3 3 3 5
5 4 3 4 4 4 4 4 4 3 7 4 4 4 4 4 4 4 5 3 4 4 3 3 4 4 3 3 5 4 6 6 6 6 6 4 4 4 4 4 4 4 4 3 3 3 3 3 3 5
5 4 3 4 4 5 2 2 5 3 3 4 4 4 4 4 4 4 5 3 4 4 3 3 4 4 3 3 4 4 4 6 6 6 4 4 4 4 4 4 4 4 4 4 4 4 4 4 4 5
5 6 3 4 4 5 2 2 11 3 3 4 4 3 3 3 3 3 5 3 4 4 3 3 4 4 3 3 4 4 4 4 4 4 4 4 4 4 4 4 4 4 4 4 4 4 4 4 4 5
5 5 5 5 5 5 2 2 5 5 5 5 5 5 5 5 5 5 5 3 4 4 3 3 4 4 4 4 4 4 4 4 4 4 4 4 4 4 4 4 4 4 4 3 3 3 3 3 3 5
7 0 0 6 6 5 2 2 12 0 0 0 0 3 3 3 3 3 5 3 4 4 4 4 4 4 4 4 4 4 4 4 4 4 4 4 4 4 4 4 4 4 4 3 3 3 3 3 3 5
3 0 0 0 6 5 2 2 5 0 0 0 0 0 0 0 0 0 5 3 4 4 4 4 4 4 4 4 4 4 4 4 4 4 4 4 4 4 4 3 3 4 4 4 4 4 4 4 4 5
3 0 0 0 0 0 0 0 0 0 0 6 6 6 6 6 0 0 5 3 4 4 4 4 4 4 4 4 4 4 6 6 4 4 4 4 4 4 4 3 3 4 4 4 4 4 4 4 4 5
3 0 0 0 0 0 0 0 0 0 0 0 6 6 6 0 0 0 5 3 3 3 4 4 4 4 4 4 4 4 5 5 5 5 5 5 5 5 5 5 5 4 4 5 5 5 5 5 5 5
3 0 0 0 0 0 0 0 6 6 0 0 0 0 0 0 0 0 5 3 4 4 4 4 4 4 4 4 4 4 5 6 0 0 0 0 6 6 0 0 0 0 0 0 0 0 0 0 3 5
5 0 0 0 0 0 6 6 6 6 6 6 0 0 0 0 0 0 5 3 4 4 4 5 2 2 5 4 4 4 5 6 0 0 0 6 6 6 0 0 0 0 0 0 0 6 6 0 3 5
5 6 6 0 0 0 0 6 6 6 6 6 6 6 0 0 0 0 5 3 3 3 3 5 2 2 13 4 6 6 5 0 0 0 0 0 0 6 6 0 0 0 0 0 6 6 6 0 3 5
5 6 0 0 0 0 6 6 6 6 6 6 6 0 0 0 0 0 5 5 5 5 5 5 2 2 5 5 5 5 5 0 0 0 0 0 0 0 0 0 0 0 0 0 0 0 0 0 3 5
3 0 0 0 0 0 0 0 0 0 0 0 0 0 0 0 0 0 0 0 0 0 0 5 2 2 12 0 0 0 5 0 0 6 6 0 0 0 0 0 6 6 6 0 0 0 0 0 0 5
3 0 0 0 0 6 6 6 0 0 0 0 0 0 0 0 0 0 0 0 0 0 0 5 2 2 5 0 0 0 5 0 0 6 6 6 0 0 0 0 6 6 0 0 0 0 0 0 0 5
3 0 0 0 6 6 6 6 6 6 6 0 0 0 0 0 6 6 6 6 0 0 0 0 0 0 0 0 0 0 5 3 0 6 0 0 6 0 0 0 0 0 0 0 0 6 6 6 6 5
3 0 0 0 6 6 6 6 6 6 6 0 0 0 0 6 6 6 6 0 0 0 0 0 6 0 0 0 0 3 5 3 0 0 0 0 0 0 0 0 0 0 0 0 0 0 0 0 0 5
3 0 0 0 6 6 6 6 6 6 6 0 0 0 0 0 6 6 6 0 0 0 0 0 6 6 0 0 0 3 5 3 0 0 6 6 0 0 0 0 0 0 6 8 6 0 0 0 0 5
3 0 0 0 0 0 6 6 6 0 0 0 0 0 0 0 0 6 6 0 0 0 0 0 0 6 0 0 0 3 5 3 0 0 0 0 0 6 0 0 0 6 0 6 6 0 0 0 0 5
3 0 6 6 6 0 0 0 0 0 0 0 0 0 0 0 0 0 0 0 0 0 0 0 0 0 0 0 0 3 5 3 0 0 0 0 0 6 6 0 0 0 0 0 0 0 0 6 6 5
5 5 5 5 5 5 5 5 5 5 5 5 5 5 5 3 3 3 3 5 3 3 3 3 3 5 5 5 5 5 5 5 3 3 3 3 3 5 5 5 5 5 5 5 5 5 5 5 5 5